NO ./texture/orange.xpm 
SO ./texture/pomme.xpm
WE ./texture/poire.xpm
EA ./texture/mangue.xpm

C 150,150,150
F 1,40,80 



                  11111
                  11111
				  11101
11111111111111111111101
10000001100000000000001
10000000100000111111111
100101000000001
101010000000001
100001000000001
100000100000001 
100000010000001   111
101000001000001   101
100000000100001   111
101000W00010001    1
100000000001001
101000000000101
111111111111111