1111111111
1110000111
1010000011
1001000001
1000110001
1000010001
1000001001
1011100001
1000000011
1111111111