SO ./texture/pomme.xpm
WE ./texture/poire.xpm
NO ./texture/orange.xpm 
EA ./texture/mangue.xpm

C 0,60,0
F 1,40,80 


		1111111111 11111111111111111111
		110000100010000000001000001
		1111000000000000000001001111111
		100000000000000000000000011111111
1111111110000000000000000000000011
1000000000000000000S0000000001111
111111111000000010000000000011111111
10000000000000010000000000001
100010000111111000000000000011111111
1111111100000000111111111111111     
100010000010001101111111001111111111
10000000000000000001010000001
1101000111010100000000000101
11110111 11100000000000010001
11111111111111111111111111111
