NO ./texture/orange.xpm 
SO ./texture/pomme.xpm
WE ./texture/poire.xpm
EA ./texture/mangue.xpm

F 1,40,80 
F 1,40,80 


        1111111111 1111111111111111
        100000000010000000001000001
        110000000000000000000100111
        10000000000000000000000001
1111111110000000000000000000000011
1000000000000000000E0000000001111
111111111000000010000000000011111111
        10000000000000010000000000001
        10001000011111100000000000001
11111111000000001     10000000000001
100010000010001101111111001111111111
10000000000000000001010000001
1101000111010100000000000101
11110111 11100000000000010001
11111111111111111111111111111