NO ./texture/orange.xpm 
SO ./texture/pomme.xpm
WE ./texture/poire.xpm
EA ./texture/mangue.xpm

C 0,60,0
F 1,40,80 


111111111111111
100000011000001
100000001000001
100101000000001
101010000000001
100001000000001
100000100000001
100000010000001
101000001000001
100000000100001
101000000010001
100000000001001
1010000N0000101
111111111111111