NO ./texture/orange.xpm 
SO ./texture/pomme.xpm
WE ./texture/poire.xpm
EA ./texture/mangue.xpm

C 0,60,0
F 1,40,80 

1111111111111111111111111111111111111111111111111111111111111111111111
1110000110000010010100000000001010000000000101000000000010100000000001
1100000010000000101000000000010100000000001010000000000101000000000101
1001010000000000101000000000000000000000000000000000000000000000000001
1000000000000000000000000000000000000000000000000000000000000000000001
1000000000001000000000100000000000000000000000001000000000000000000001
1000000000000000000000000000000000010000000000000000000000000000000001
1000000000000000001000000000001000010000000000000000000000000000000001
1000000000000000000100000000000000010000000000000000000000000000000001
1000000000000000000000000000110000000000000001000000000000000000000001
1000000000000000000000000100000000100000010000000000000000000000000001
1000000100000000000000000000000000000000010000000000000000000100000001
1000000000000000000000000000000010000000011110000100000000000000000001
1000000000000000000000010000000000000000100000000000000N00000000000001
1000000000000000000000000000000000000000000000000000000000000000000001
1000000000000000000000000000000000000000000000000000000000000000000001
1000000000001000000000000000000100001100000000000000000000000000000001
1000000000000000000000000000000000000000000000000000000000000000000011
1111111111111111111111111111111111111111111111111111111111111111111111